"filename", "language", "C#", "comment", "blank", "total"
"c:\Users\wadan\Desktop\Man-Brother-s-Poker\Assets\Scripts\BestHand.cs", "C#", 77, -21, 7, 63
"c:\Users\wadan\Desktop\Man-Brother-s-Poker\Assets\Scripts\GameSc\GameSceneUpdater.cs", "C#", 2, 2, 1, 5
"c:\Users\wadan\Desktop\Man-Brother-s-Poker\Assets\Scripts\GameSc\UI\Canvas\ScreenCanvas\ScreenCanvas.cs", "C#", 4, 1, 2, 7
"c:\Users\wadan\Desktop\Man-Brother-s-Poker\Assets\Scripts\GameSc\UI\Canvas\ScreenCanvas\SidePotPanel.cs", "C#", 19, 0, 3, 22
"c:\Users\wadan\Desktop\Man-Brother-s-Poker\Assets\Scripts\GameSc\UI\Sprite\CardSprite.cs", "C#", 0, 0, 1, 1
"c:\Users\wadan\Desktop\Man-Brother-s-Poker\Assets\Scripts\GameTable.cs", "C#", 26, 5, 8, 39
"c:\Users\wadan\Desktop\Man-Brother-s-Poker\Assets\Scripts\Player.cs", "C#", 1, 0, 1, 2
"c:\Users\wadan\Desktop\Man-Brother-s-Poker\Assets\Scripts\PotWinnerManager.cs", "C#", 116, 22, 33, 171
"c:\Users\wadan\Desktop\Man-Brother-s-Poker\Assets\Scripts\ScriptTester.cs", "C#", -33, -44, -8, -85
"c:\Users\wadan\Desktop\Man-Brother-s-Poker\Assets\Scripts\Test\ScriptTester.cs", "C#", 115, 54, 35, 204
"c:\Users\wadan\Desktop\Man-Brother-s-Poker\Assets\Scripts\Test\SubPlaceHolder.cs", "C#", 9, 0, 2, 11
"Total", "-", 336, 19, 85, 440