"filename", "language", "C#", "comment", "blank", "total"
"c:\Users\wadan\Desktop\Man-Brother-s-Poker\Assets\Scripts\GameSc\AnimTurningPointHandler.cs", "C#", -2, 0, 0, -2
"c:\Users\wadan\Desktop\Man-Brother-s-Poker\Assets\Scripts\GameSc\CamController.cs", "C#", 48, 14, 9, 71
"c:\Users\wadan\Desktop\Man-Brother-s-Poker\Assets\Scripts\GameSc\Manager\GameSceneUpdater.cs", "C#", 97, -10, 23, 110
"c:\Users\wadan\Desktop\Man-Brother-s-Poker\Assets\Scripts\GameSc\Manager\WorldAnimHandler.cs", "C#", 44, 5, 9, 58
"c:\Users\wadan\Desktop\Man-Brother-s-Poker\Assets\Scripts\GameSc\TableObjects\CardCloser.cs", "C#", 12, 2, 3, 17
"c:\Users\wadan\Desktop\Man-Brother-s-Poker\Assets\Scripts\GameSc\TableObjects\TableCardHandler.cs", "C#", -5, -1, 0, -6
"c:\Users\wadan\Desktop\Man-Brother-s-Poker\Assets\Scripts\GameSc\UI\Canvas\PlayerCanvas.cs", "C#", 5, 4, 2, 11
"c:\Users\wadan\Desktop\Man-Brother-s-Poker\Assets\Scripts\GameSc\UI\Canvas\ScreenCanvas\BettingPanel.cs", "C#", 6, -17, -1, -12
"c:\Users\wadan\Desktop\Man-Brother-s-Poker\Assets\Scripts\GameSc\UI\Canvas\ScreenCanvas\PieButton.cs", "C#", 0, -4, -1, -5
"c:\Users\wadan\Desktop\Man-Brother-s-Poker\Assets\Scripts\GameSc\UI\Canvas\ScreenCanvas\ScreenCanvas.cs", "C#", 38, 6, 4, 48
"c:\Users\wadan\Desktop\Man-Brother-s-Poker\Assets\Scripts\GameSc\UI\Canvas\ScreenCanvas\ShowDownPanel.cs", "C#", 5, 0, 1, 6
"c:\Users\wadan\Desktop\Man-Brother-s-Poker\Assets\Scripts\GameSc\UI\Canvas\Timer.cs", "C#", 43, 2, 9, 54
"c:\Users\wadan\Desktop\Man-Brother-s-Poker\Assets\Scripts\GameTable.cs", "C#", -25, -5, -7, -37
"c:\Users\wadan\Desktop\Man-Brother-s-Poker\Assets\Scripts\PotWinnerManager.cs", "C#", 5, 2, 3, 10
"c:\Users\wadan\Desktop\Man-Brother-s-Poker\Assets\Scripts\Test\ScriptTester.cs", "C#", 16, 0, 1, 17
"c:\Users\wadan\Desktop\Man-Brother-s-Poker\Assets\Scripts\Util\ExtensionMethods.cs", "C#", 10, 0, 2, 12
"c:\Users\wadan\Desktop\Man-Brother-s-Poker\Assets\Scripts\WebSocketScript\GameMsgHandler.cs", "C#", 8, 0, -1, 7
"Total", "-", 305, -2, 56, 359