"filename", "language", "C#", "comment", "blank", "total"
"c:\Users\wadan\Desktop\Man-Brother-s-Poker\Assets\Scripts\BestHand.cs", "C#", 25, 4, 5, 34
"c:\Users\wadan\Desktop\Man-Brother-s-Poker\Assets\Scripts\GameSc\GameSceneUpdater.cs", "C#", 32, 14, 13, 59
"c:\Users\wadan\Desktop\Man-Brother-s-Poker\Assets\Scripts\GameSc\UI\Canvas\PlayerCanvas.cs", "C#", 4, 3, -1, 6
"c:\Users\wadan\Desktop\Man-Brother-s-Poker\Assets\Scripts\GameSc\UI\Canvas\ScreenCanvas\BettingPanel.cs", "C#", 1, 1, 1, 3
"c:\Users\wadan\Desktop\Man-Brother-s-Poker\Assets\Scripts\GameSc\UI\Canvas\ScreenCanvas\ScreenCanvas.cs", "C#", 7, 2, 2, 11
"c:\Users\wadan\Desktop\Man-Brother-s-Poker\Assets\Scripts\GameSc\UI\Canvas\ScreenCanvas\WinnerPanel.cs", "C#", 143, 10, 24, 177
"c:\Users\wadan\Desktop\Man-Brother-s-Poker\Assets\Scripts\GameSc\UI\Sprite\CardSprite.cs", "C#", 1, 0, 0, 1
"c:\Users\wadan\Desktop\Man-Brother-s-Poker\Assets\Scripts\GameTable.cs", "C#", 24, 5, 6, 35
"c:\Users\wadan\Desktop\Man-Brother-s-Poker\Assets\Scripts\PotWinnerManager.cs", "C#", 24, 1, 6, 31
"c:\Users\wadan\Desktop\Man-Brother-s-Poker\Assets\Scripts\Test\ScriptTester.cs", "C#", 12, 13, 4, 29
"c:\Users\wadan\Desktop\Man-Brother-s-Poker\Assets\Scripts\WebSocketScript\GameMsgHandler.cs", "C#", 4, 3, 0, 7
"Total", "-", 277, 56, 60, 393