"filename", "language", "C#", "comment", "blank", "total"
"c:\Users\wadan\Desktop\Man-Brother-s-Poker\Assets\Scripts\EnteringSc\EntCamController.cs", "C#", 120, 25, 40, 185
"c:\Users\wadan\Desktop\Man-Brother-s-Poker\Assets\Scripts\GameSc\CharacterObject\GameCharacter.cs", "C#", 0, 4, 1, 5
"c:\Users\wadan\Desktop\Man-Brother-s-Poker\Assets\Scripts\GameSc\ChipObject\ChipHolder.cs", "C#", 0, 2, 0, 2
"c:\Users\wadan\Desktop\Man-Brother-s-Poker\Assets\Scripts\GameSc\Manager\GameSceneUpdater.cs", "C#", 29, 8, 7, 44
"c:\Users\wadan\Desktop\Man-Brother-s-Poker\Assets\Scripts\GameSc\Manager\WorldAnimHandler.cs", "C#", 8, 2, 5, 15
"c:\Users\wadan\Desktop\Man-Brother-s-Poker\Assets\Scripts\GameSc\TableObjects\TableChipHandler.cs", "C#", 15, -15, -1, -1
"c:\Users\wadan\Desktop\Man-Brother-s-Poker\Assets\Scripts\GameSc\UI\Canvas\PlayerCanvas.cs", "C#", 41, 4, 6, 51
"c:\Users\wadan\Desktop\Man-Brother-s-Poker\Assets\Scripts\GameSc\UI\Canvas\ScreenCanvas\ScreenCanvas.cs", "C#", 19, -19, 5, 5
"c:\Users\wadan\Desktop\Man-Brother-s-Poker\Assets\Scripts\GameSc\UI\Canvas\ScreenCanvas\ShowDownPanel.cs", "C#", 4, 1, 1, 6
"c:\Users\wadan\Desktop\Man-Brother-s-Poker\Assets\Scripts\GameSc\UI\Canvas\ScreenCanvas\SidePotPanel.cs", "C#", 4, 0, 1, 5
"c:\Users\wadan\Desktop\Man-Brother-s-Poker\Assets\Scripts\GameSc\UI\Canvas\ScreenCanvas\WinnerPanel.cs", "C#", -7, 2, 1, -4
"c:\Users\wadan\Desktop\Man-Brother-s-Poker\Assets\Scripts\GameSc\UI\Canvas\Timer.cs", "C#", 4, 0, 1, 5
"c:\Users\wadan\Desktop\Man-Brother-s-Poker\Assets\Scripts\GameSc\UI\GameMenu.cs", "C#", 5, 2, 2, 9
"c:\Users\wadan\Desktop\Man-Brother-s-Poker\Assets\Scripts\GameTable.cs", "C#", 57, 3, 8, 68
"c:\Users\wadan\Desktop\Man-Brother-s-Poker\Assets\Scripts\GeneralManager\GameManager.cs", "C#", -72, -14, -21, -107
"c:\Users\wadan\Desktop\Man-Brother-s-Poker\Assets\Scripts\Player.cs", "C#", 2, 1, 1, 4
"c:\Users\wadan\Desktop\Man-Brother-s-Poker\Assets\Scripts\PotWinnerManager.cs", "C#", 18, 1, 1, 20
"c:\Users\wadan\Desktop\Man-Brother-s-Poker\Assets\Scripts\Test\ScriptTester.cs", "C#", -79, -59, -23, -161
"c:\Users\wadan\Desktop\Man-Brother-s-Poker\Assets\Scripts\Util\UnityMainThread.cs", "C#", 7, 0, 3, 10
"c:\Users\wadan\Desktop\Man-Brother-s-Poker\Assets\Scripts\WebSocketScript\GameMsgHandler.cs", "C#", 22, 2, 1, 25
"c:\Users\wadan\Desktop\Man-Brother-s-Poker\Assets\Scripts\WebSocketScript\RoomMsgHandler.cs", "C#", 26, 9, 8, 43
"Total", "-", 223, -41, 47, 229